111111111111111
10010000C000001
1P0100111111001
1101001000C0001
1001001C0111111
100100100000001
10010C1111110A1
10C1011A1111001
100101000000001
100001E11010111
10011101C010111
1A0111111110001
10C100000000C01
1001C0111111111
10010000C0000C1
111111111111111