111111111111111
10010000C000001
1P0100111111001
100100100000001
1001001C0111111
100100100000001
10010C111111001
100101101111001
100101000000001
100001011010111
10011101C010111
100111111110001
10C100000000C01
1001C0111111111
10010000C0E00C1
111111111111111