111111111111111111111
10010000C0000000000C1
1P0100111111111100001
1101001001C0000100001
1001001C0111110001001
1001001000E0011101101
10010C1111110A0001101
10C1011A1111000000001
100101000000010111101
100001C110101101AC101
10011101C010110000001
111111111111111111111